Json	KEYWORD1
toStdString	KEYWORD2
find_first_of_any	KEYWORD2
split_into_tokens	KEYWORD2
split_by_string_literals	KEYWORD2
split	KEYWORD2
parse	KEYWORD2
parseValue	KEYWORD2
parseArray	KEYWORD2
parseObject	KEYWORD2
parseProperty	KEYWORD2
parseBool	KEYWORD2
parseNumber	KEYWORD2
parseString	KEYWORD2
to_string	KEYWORD2
atoi	KEYWORD2
atof	KEYWORD2
JsonObject	KEYWORD1
Type	KEYWORD1
is	KEYWORD2
type	KEYWORD2
asInt	KEYWORD2
asFloat	KEYWORD2
asBool	KEYWORD2
asProperty	KEYWORD2
asArray		KEYWORD2
asObject	KEYWORD2
freeMemory	KEYWORD2
copyTo	KEYWORD2
moveTo	KEYWORD2
as	KEYWORD2
